position,id,name,location,abbreviation,gp,wins,losses,OTL,points,winPercent,ROW,goalsFor,goalsAgainst,goalDiff,home_wins,home_losses,home_OTL,away_wins,away_losses,away_OTL,shootout_wins,shootout_losses,season
1,5,New England Wolfpack,New England,NEW,50,42,7,1,85,0.850,40,196,81,115,22,3,0,20,4,1,2,0,53
2,2,Hamilton Steelhawks,Hamilton,HAM,50,40,7,3,83,0.830,37,207,103,104,20,3,2,20,4,1,3,3,53
3,13,Los Angeles Panthers,Los Angeles,LAP,50,35,11,4,74,0.740,35,168,119,49,20,3,2,15,8,2,0,3,53
4,0,Buffalo Stampede,Buffalo,BUF,50,35,14,1,71,0.710,34,196,109,87,15,9,1,20,5,0,1,0,53
5,9,Edmonton Blizzard,Edmonton,EDM,50,32,13,5,69,0.690,31,172,121,51,19,6,0,13,7,5,1,3,53
6,8,Calgary Dragons,Calgary,CGY,50,31,14,5,67,0.670,30,189,134,55,19,5,1,12,9,4,1,4,53
7,14,New Orleans Specters,New Orleans,NOL,50,29,17,4,62,0.620,23,146,122,24,17,6,2,12,11,2,6,1,53
8,12,San Francisco Pride,San Francisco,SFP,50,27,20,3,57,0.570,26,155,132,23,15,9,1,12,11,2,1,1,53
9,4,Manhattan Rage,Manhattan,MAN,50,25,22,3,53,0.530,23,159,134,25,12,12,1,13,10,2,2,2,53
10,1,Chicago Syndicate,Chicago,CHI,50,24,24,2,50,0.500,23,134,148,-14,12,11,2,12,13,0,1,1,53
11,7,West Kendall Platoon,West Kendall,WKP,50,21,22,7,49,0.490,18,109,156,-47,9,14,2,12,8,5,3,5,53
12,11,Winnipeg Jets,Winnipeg,WPG,50,22,25,3,47,0.470,22,132,148,-16,14,9,2,8,16,1,0,1,53
13,10,Minnesota Chiefs,Minnesota,MIN,50,12,33,5,29,0.290,10,90,183,-93,10,14,1,2,19,4,2,1,53
14,6,Tampa Bay Barracuda,Tampa Bay,TBB,50,10,38,2,22,0.220,6,98,197,-99,4,19,2,6,19,0,4,2,53
15,15,Texas Renegades,Texas,TEX,50,9,41,0,18,0.180,8,101,194,-93,8,17,0,1,24,0,1,0,53
16,3,Toronto North Stars,Toronto,TOR,50,6,41,3,15,0.150,5,84,255,-171,3,20,2,3,21,1,1,2,53
1,0,Buffalo Stampede,Buffalo,BUF,50,41,7,2,84,0.840,41,217,93,124,23,2,0,18,5,2,0,0,54
2,2,Hamilton Steelhawks,Hamilton,HAM,50,38,10,2,78,0.780,36,220,106,114,23,1,1,15,9,1,2,1,54
3,1,Chicago Syndicate,Chicago,CHI,50,35,13,2,72,0.720,35,226,107,119,19,6,0,16,7,2,0,0,54
4,13,Los Angeles Panthers,Los Angeles,LAP,50,33,17,0,66,0.660,31,160,114,46,18,7,0,15,10,0,2,0,54
5,14,New Orleans Specters,New Orleans,NOL,50,30,16,4,64,0.640,27,163,138,25,13,10,2,17,6,2,3,0,54
6,4,Manhattan Rage,Manhattan,MAN,50,29,17,4,62,0.620,28,162,126,36,17,7,1,12,10,3,1,4,54
7,9,Edmonton Blizzard,Edmonton,EDM,50,29,18,3,61,0.610,29,180,145,35,17,7,1,12,11,2,0,1,54
8,5,New England Wolfpack,New England,NEW,50,28,21,1,57,0.570,26,171,113,58,14,10,1,14,11,0,2,0,54
9,8,Calgary Dragons,Calgary,CGY,50,26,19,5,57,0.570,24,162,157,5,17,6,2,9,13,3,2,3,54
10,15,Texas Renegades,Texas,TEX,50,26,19,5,57,0.570,23,138,138,0,18,5,2,8,14,3,3,4,54
11,12,San Francisco Pride,San Francisco,SFP,50,27,22,1,55,0.550,24,162,165,-3,15,10,0,12,12,1,3,1,54
12,11,Winnipeg Jets,Winnipeg,WPG,50,19,29,2,40,0.400,18,138,166,-28,13,12,0,6,17,2,1,1,54
13,7,Baltimore Platoon,Baltimore,BAP,50,15,33,2,32,0.320,15,117,181,-64,8,16,1,7,17,1,0,2,54
14,10,Minnesota Chiefs,Minnesota,MIN,50,13,34,3,29,0.290,11,107,216,-109,9,13,3,4,21,0,2,2,54
15,3,Toronto North Stars,Toronto,TOR,50,11,37,2,24,0.240,11,101,195,-94,7,17,1,4,20,1,0,2,54
16,6,Tampa Bay Barracuda,Tampa Bay,TBB,50,0,50,0,0,0.000,0,45,309,-264,0,25,0,0,25,0,0,0,54
1,0,Buffalo Stampede,Buffalo,BUF,50,40,10,0,80,0.800,40,226,98,128,23,2,0,17,8,0,0,0,55
2,9,Edmonton Blizzard,Edmonton,EDM,50,39,9,2,80,0.800,39,232,119,113,22,2,1,17,7,1,0,1,55
3,4,Manhattan Rage,Manhattan,MAN,50,36,10,4,76,0.760,30,171,117,54,20,5,0,16,5,4,6,2,55
4,14,New Orleans Specters,New Orleans,NOL,50,34,11,5,73,0.730,32,202,120,82,18,6,1,16,5,4,2,2,55
5,2,Hamilton Steelhawks,Hamilton,HAM,50,33,14,3,69,0.690,33,198,107,91,17,6,2,16,8,1,0,2,55
6,8,Calgary Dragons,Calgary,CGY,50,31,13,6,68,0.680,28,168,120,48,17,5,3,14,8,3,3,4,55
7,1,Chicago Syndicate,Chicago,CHI,50,30,17,3,63,0.630,29,187,116,71,16,7,2,14,10,1,1,3,55
8,5,New England Wolfpack,New England,NEW,50,27,16,7,61,0.610,27,149,122,27,20,4,1,7,12,6,0,6,55
9,15,Texas Renegades,Texas,TEX,50,28,19,3,59,0.590,25,153,141,12,16,8,1,12,11,2,3,1,55
10,11,Winnipeg Jets,Winnipeg,WPG,50,23,24,3,49,0.490,21,149,168,-19,12,11,2,11,13,1,2,3,55
11,13,Los Angeles Panthers,Los Angeles,LAP,50,19,29,2,40,0.400,18,136,158,-22,11,13,1,8,16,1,1,2,55
12,12,San Francisco Pride,San Francisco,SFP,50,16,32,2,34,0.340,12,114,207,-93,7,16,2,9,16,0,4,1,55
13,7,Baltimore Platoon,Baltimore,BAP,50,14,32,4,32,0.320,10,101,178,-77,7,16,2,7,16,2,4,3,55
14,10,Minnesota Chiefs,Minnesota,MIN,50,12,38,0,24,0.240,9,92,191,-99,6,19,0,6,19,0,3,0,55
15,3,Toronto North Stars,Toronto,TOR,50,10,39,1,21,0.210,10,87,220,-133,5,19,1,5,20,0,0,1,55
16,6,Tampa Bay Barracuda,Tampa Bay,TBB,50,8,42,0,16,0.160,6,77,260,-183,6,19,0,2,23,0,2,0,55
1,2,Hamilton Steelhawks,Hamilton,HAM,50,40,4,6,86,0.860,37,228,91,137,21,0,4,19,4,2,3,4,56
2,8,Calgary Dragons,Calgary,CGY,50,38,8,4,80,0.800,36,190,85,105,18,5,2,20,3,2,2,2,56
3,1,Chicago Syndicate,Chicago,CHI,50,37,9,4,78,0.780,36,201,98,103,19,6,0,18,3,4,1,4,56
4,4,Manhattan Rage,Manhattan,MAN,50,35,14,1,71,0.710,34,195,115,80,13,12,0,22,2,1,1,0,56
5,0,Buffalo Stampede,Buffalo,BUF,50,34,16,0,68,0.680,34,187,112,75,16,9,0,18,7,0,0,0,56
6,15,Texas Renegades,Texas,TEX,50,34,16,0,68,0.680,31,178,128,50,17,8,0,17,8,0,3,0,56
7,9,Edmonton Blizzard,Edmonton,EDM,50,32,17,1,65,0.650,32,192,123,69,18,7,0,14,10,1,0,1,56
8,14,New Orleans Specters,New Orleans,NOL,50,28,15,7,63,0.630,24,148,119,29,12,10,3,16,5,4,4,2,56
9,18,Atlanta Inferno,Atlanta,ATL,50,25,22,3,53,0.530,25,175,153,22,14,8,3,11,14,0,0,3,56
10,5,New England Wolfpack,New England,NEW,50,25,23,2,52,0.520,23,136,163,-27,15,9,1,10,14,1,2,1,56
11,13,Los Angeles Panthers,Los Angeles,LAP,50,24,22,4,52,0.520,21,109,135,-26,15,7,3,9,15,1,3,3,56
12,11,Winnipeg Jets,Winnipeg,WPG,50,21,26,3,45,0.450,21,127,167,-40,10,14,1,11,12,2,0,1,56
13,3,Toronto North Stars,Toronto,TOR,50,19,28,3,41,0.410,17,118,156,-38,11,12,2,8,16,1,2,2,56
14,19,Seattle Argonauts,Seattle,SEA,50,17,29,4,38,0.380,16,113,156,-43,10,14,1,7,15,3,1,3,56
15,10,Minnesota Monarchs,Minnesota,MIN,50,16,32,2,34,0.340,14,104,177,-73,12,12,1,4,20,1,2,1,56
16,6,Tampa Bay Barracuda,Tampa Bay,TBB,50,11,37,2,24,0.240,9,78,223,-145,5,18,2,6,19,0,2,1,56
17,7,Baltimore Platoon,Baltimore,BAP,50,10,37,3,23,0.230,6,87,193,-106,8,17,0,2,20,3,4,2,56
18,12,San Francisco Pride,San Francisco,SFP,50,4,42,4,12,0.120,2,71,243,-172,1,21,3,3,21,1,2,2,56
1,2,Hamilton Steelhawks,Hamilton,HAM,66,53,9,4,110,0.833,52,283,147,136,30,1,2,23,8,2,1,4,57
2,1,Chicago Syndicate,Chicago,CHI,66,51,12,3,105,0.795,44,280,142,138,28,3,2,23,9,1,7,2,57
3,0,Buffalo Stampede,Buffalo,BUF,66,50,13,3,103,0.780,46,254,148,106,28,4,1,22,9,2,4,2,57
4,9,Edmonton Blizzard,Edmonton,EDM,66,45,16,5,95,0.720,43,266,184,82,25,5,3,20,11,2,2,4,57
5,8,Calgary Dragons,Calgary,CGY,66,44,19,3,91,0.689,42,237,157,80,25,7,1,19,12,2,2,3,57
6,15,Texas Renegades,Texas,TEX,66,44,20,2,90,0.682,42,244,161,83,25,7,1,19,13,1,2,2,57
7,4,Manhattan Rage,Manhattan,MAN,66,42,20,4,88,0.667,40,252,171,81,24,5,4,18,15,0,2,2,57
8,13,Los Angeles Panthers,Los Angeles,LAP,66,36,22,8,80,0.606,33,193,176,17,22,6,5,14,16,3,3,7,57
9,11,Winnipeg Jets,Winnipeg,WPG,66,37,26,3,77,0.583,32,195,173,22,21,10,2,16,16,1,5,1,57
10,3,Toronto North Stars,Toronto,TOR,66,34,26,6,74,0.561,32,192,181,11,20,10,3,14,16,3,2,3,57
11,18,Atlanta Inferno,Atlanta,ATL,66,27,33,6,60,0.455,24,199,223,-24,15,15,3,12,18,3,3,2,57
12,5,New England Wolfpack,New England,NEW,66,24,37,5,53,0.402,21,180,231,-51,13,20,0,11,17,5,3,4,57
13,14,New Orleans Specters,New Orleans,NOL,66,22,41,3,47,0.356,19,137,221,-84,12,18,3,10,23,0,3,2,57
14,19,Seattle Argonauts,Seattle,SEA,66,22,42,2,46,0.348,21,138,219,-81,14,19,0,8,23,2,1,0,57
15,10,Minnesota Monarchs,Minnesota,MIN,66,21,42,3,45,0.341,20,163,234,-71,10,20,3,11,22,0,1,1,57
16,6,Tampa Bay Barracuda,Tampa Bay,TBB,66,17,46,3,37,0.280,16,125,295,-170,13,20,0,4,26,3,1,2,57
17,7,Baltimore Platoon,Baltimore,BAP,66,13,48,5,31,0.235,13,112,246,-134,8,21,4,5,27,1,0,3,57
18,12,San Francisco Pride,San Francisco,SFP,66,12,53,1,25,0.189,9,113,254,-141,8,25,0,4,28,1,3,1,57
1,15,Texas Renegades,Texas,TEX,66,54,11,1,109,0.826,51,283,136,147,28,5,0,26,6,1,3,1,58
2,2,Hamilton Steelhawks,Hamilton,HAM,66,50,13,3,103,0.780,48,261,169,92,24,7,2,26,6,1,2,3,58
3,3,Toronto North Stars,Toronto,TOR,66,46,14,6,98,0.742,43,240,159,81,21,7,5,25,7,1,3,2,58
4,8,Calgary Dragons,Calgary,CGY,66,44,19,3,91,0.689,42,239,158,81,26,7,0,18,12,3,2,2,58
5,0,Buffalo Stampede,Buffalo,BUF,66,42,18,6,90,0.682,42,253,134,119,23,8,2,19,10,4,0,6,58
6,1,Chicago Syndicate,Chicago,CHI,66,42,20,4,88,0.667,40,240,130,110,21,9,3,21,11,1,2,1,58
7,9,Edmonton Blizzard,Edmonton,EDM,66,42,21,3,87,0.659,38,267,204,63,23,8,2,19,13,1,4,2,58
8,4,Manhattan Rage,Manhattan,MAN,66,34,26,6,74,0.561,32,217,198,19,18,12,3,16,14,3,2,4,58
9,13,Los Angeles Panthers,Los Angeles,LAP,66,29,31,6,64,0.485,25,198,222,-24,17,12,4,12,19,2,4,6,58
10,18,Atlanta Inferno,Atlanta,ATL,66,30,34,2,62,0.470,26,212,225,-13,15,16,2,15,18,0,4,0,58
11,7,Baltimore Platoon,Baltimore,BAP,66,27,34,5,59,0.447,24,181,241,-60,15,15,3,12,19,2,3,3,58
12,11,Winnipeg Aurora,Winnipeg,WPG,66,26,37,3,55,0.417,24,170,208,-38,19,13,1,7,24,2,2,3,58
13,6,Tampa Bay Barracuda,Tampa Bay,TBB,66,26,38,2,54,0.409,22,181,240,-59,15,18,0,11,20,2,4,0,58
14,5,New England Wolfpack,New England,NEW,66,25,37,4,54,0.409,18,149,240,-91,14,17,2,11,20,2,7,2,58
15,10,Minnesota Monarchs,Minnesota,MIN,66,23,36,7,53,0.402,20,153,222,-69,15,13,5,8,23,2,3,3,58
16,19,Seattle Argonauts,Seattle,SEA,66,24,38,4,52,0.394,21,164,235,-71,18,13,2,6,25,2,3,2,58
17,12,San Francisco Pride,San Francisco,SFP,66,20,40,6,46,0.348,19,158,263,-105,14,16,3,6,24,3,1,6,58
18,14,New Orleans Specters,New Orleans,NOL,66,10,50,6,26,0.197,9,135,317,-182,9,23,1,1,27,5,1,4,58
1,2,Hamilton Steelhawks,Hamilton,HAM,66,56,9,1,113,0.856,56,308,145,163,29,3,1,27,6,0,0,0,59
2,0,Buffalo Stampede,Buffalo,BUF,66,50,13,3,103,0.780,46,305,172,133,26,6,1,24,7,2,4,2,59
3,15,Texas Renegades,Texas,TEX,66,49,15,2,100,0.758,49,272,141,131,28,5,0,21,10,2,0,2,59
4,1,Chicago Syndicate,Chicago,CHI,66,49,15,2,100,0.758,47,264,151,113,26,6,1,23,9,1,2,2,59
5,3,Toronto North Stars,Toronto,TOR,66,44,17,5,93,0.705,40,243,176,67,23,8,2,21,9,3,4,3,59
6,8,Calgary Dragons,Calgary,CGY,66,42,20,4,88,0.667,37,228,184,44,23,9,1,19,11,3,5,3,59
7,19,Seattle Argonauts,Seattle,SEA,66,35,27,4,74,0.561,34,203,170,33,18,13,2,17,14,2,1,1,59
8,9,Edmonton Blizzard,Edmonton,EDM,66,34,26,6,74,0.561,32,226,204,22,18,11,4,16,15,2,2,4,59
9,13,Los Angeles Panthers,Los Angeles,LAP,66,31,27,8,70,0.530,27,205,209,-4,12,17,4,19,10,4,4,5,59
10,10,Minnesota Monarchs,Minnesota,MIN,66,30,34,2,62,0.470,26,164,226,-62,15,16,2,15,18,0,4,1,59
11,12,San Francisco Pride,San Francisco,SFP,66,26,35,5,57,0.432,23,158,223,-65,12,17,4,14,18,1,3,2,59
12,18,Atlanta Inferno,Atlanta,ATL,66,25,35,6,56,0.424,22,213,251,-38,13,17,3,12,18,3,3,5,59
13,11,Winnipeg Aurora,Winnipeg,WPG,66,25,37,4,54,0.409,22,152,230,-78,15,14,4,10,23,0,3,2,59
14,7,Baltimore Platoon,Baltimore,BAP,66,23,39,4,50,0.379,20,177,259,-82,16,15,2,7,24,2,3,3,59
15,6,Tampa Bay Barracuda,Tampa Bay,TBB,66,20,38,8,48,0.364,18,185,227,-42,11,17,5,9,21,3,2,4,59
16,5,New England Wolfpack,New England,NEW,66,22,41,3,47,0.356,21,171,246,-75,15,16,2,7,25,1,1,1,59
17,4,Manhattan Rage,Manhattan,MAN,66,21,41,4,46,0.348,17,148,248,-100,11,20,2,10,21,2,4,3,59
18,14,New Orleans Specters,New Orleans,NOL,66,12,49,5,29,0.220,12,125,285,-160,7,24,2,5,25,3,0,2,59
1,0,Buffalo Stampede,Buffalo,BUF,66,51,10,5,107,0.811,48,306,166,140,26,5,2,25,5,3,3,2,60
2,2,Hamilton Steelhawks,Hamilton,HAM,66,49,15,2,100,0.758,46,305,164,141,29,3,1,20,12,1,3,1,60
3,7,Baltimore Platoon,Baltimore,BAP,66,47,17,2,96,0.727,43,226,169,57,27,5,1,20,12,1,4,2,60
4,1,Chicago Syndicate,Chicago,CHI,66,45,19,2,92,0.697,41,267,175,92,27,5,1,18,14,1,4,1,60
5,3,Toronto North Stars,Toronto,TOR,66,42,18,6,90,0.682,41,230,174,56,23,5,5,19,13,1,1,4,60
6,15,Texas Renegades,Texas,TEX,66,43,19,4,90,0.682,40,240,162,78,22,9,2,21,10,2,3,2,60
7,8,Calgary Dragons,Calgary,CGY,66,38,21,7,83,0.629,38,235,173,62,20,12,1,18,9,6,0,5,60
8,13,Los Angeles Panthers,Los Angeles,LAP,66,39,24,3,81,0.614,37,255,210,45,23,10,0,16,14,3,2,2,60
9,9,Edmonton Blizzard,Edmonton,EDM,66,34,26,6,74,0.561,31,229,219,10,18,10,5,16,16,1,3,4,60
10,18,Atlanta Inferno,Atlanta,ATL,66,34,27,5,73,0.553,29,208,186,22,19,11,3,15,16,2,5,3,60
11,19,Seattle Argonauts,Seattle,SEA,66,31,26,9,71,0.538,30,223,220,3,22,8,3,9,18,6,1,7,60
12,6,Tampa Bay Barracuda,Tampa Bay,TBB,66,29,31,6,64,0.485,26,209,203,6,18,12,3,11,19,3,3,4,60
13,10,Minnesota Monarchs,Minnesota,MIN,66,29,31,6,64,0.485,23,164,216,-52,18,13,2,11,18,4,6,4,60
14,21,Philadelphia Forge,Philadelphia,PHI,66,30,33,3,63,0.477,27,198,217,-19,19,13,1,11,20,2,3,2,60
15,5,New England Wolfpack,New England,NEW,66,27,31,8,62,0.470,24,198,233,-35,16,13,4,11,18,4,3,4,60
16,20,Montreal Patriotes,Montreal,MTL,66,22,39,5,49,0.371,21,192,264,-72,11,18,4,11,21,1,1,2,60
17,12,San Francisco Pride,San Francisco,SFP,66,20,41,5,45,0.341,17,146,255,-109,12,19,2,8,22,3,3,0,60
18,4,Manhattan Rage,Manhattan,MAN,66,19,45,2,40,0.303,16,161,277,-116,9,23,1,10,22,1,3,1,60
19,11,Winnipeg Aurora,Winnipeg,WPG,66,17,44,5,39,0.295,16,124,258,-134,11,19,3,6,25,2,1,4,60
20,14,New Orleans Specters,New Orleans,NOL,66,14,50,2,30,0.227,11,138,313,-175,10,22,1,4,28,1,3,1,60
1,2,Hamilton Steelhawks,Hamilton,HAM,66,57,8,1,115,0.871,54,315,141,174,30,3,0,27,5,1,3,0,61
2,15,Texas Renegades,Texas,TEX,66,49,15,2,100,0.758,46,268,161,107,27,6,0,22,9,2,3,0,61
3,7,Baltimore Platoon,Baltimore,BAP,66,49,15,2,100,0.758,42,265,166,99,27,6,0,22,9,2,7,2,61
4,0,Buffalo Stampede,Buffalo,BUF,66,46,16,4,96,0.727,44,267,150,117,30,1,2,16,15,2,2,3,61
5,1,Chicago Syndicate,Chicago,CHI,66,42,23,1,85,0.644,41,261,165,96,25,8,0,17,15,1,1,1,61
6,6,Tampa Bay Barracuda,Tampa Bay,TBB,66,38,23,5,81,0.614,35,223,186,37,20,12,1,18,11,4,3,3,61
7,5,New England Wolfpack,New England,NEW,66,36,24,6,78,0.591,35,231,193,38,21,9,3,15,15,3,1,4,61
8,9,Edmonton Blizzard,Edmonton,EDM,66,36,28,2,74,0.561,33,210,222,-12,25,7,1,11,21,1,3,1,61
9,8,Calgary Dragons,Calgary,CGY,66,34,26,6,74,0.561,29,206,201,5,19,11,3,15,15,3,5,4,61
10,3,Toronto North Stars,Toronto,TOR,66,33,29,4,70,0.530,31,209,197,12,16,14,3,17,15,1,2,3,61
11,21,Philadelphia Forge,Philadelphia,PHI,66,30,27,9,69,0.523,29,199,197,2,17,13,3,13,14,6,1,5,61
12,18,Atlanta Inferno,Atlanta,ATL,66,32,30,4,68,0.515,29,198,214,-16,19,13,1,13,17,3,3,2,61
13,13,Los Angeles Panthers,Los Angeles,LAP,66,31,29,6,68,0.515,29,202,236,-34,16,15,2,15,14,4,2,1,61
14,19,Seattle Argonauts,Seattle,SEA,66,31,30,5,67,0.508,29,217,220,-3,18,14,1,13,16,4,2,2,61
15,10,Minnesota Monarchs,Minnesota,MIN,66,30,30,6,66,0.500,30,192,197,-5,15,14,4,15,16,2,0,4,61
16,12,San Francisco Pride,San Francisco,SFP,66,28,31,7,63,0.477,27,197,196,1,15,13,5,13,18,2,1,4,61
17,14,New Orleans Specters,New Orleans,NOL,66,26,37,3,55,0.417,20,165,260,-95,16,16,1,10,21,2,6,2,61
18,20,Montreal Patriotes,Montreal,MTL,66,20,40,6,46,0.348,18,159,234,-75,11,19,3,9,21,3,2,5,61
19,4,Manhattan Rage,Manhattan,MAN,66,9,56,1,19,0.144,8,98,301,-203,4,29,0,5,27,1,1,1,61
20,11,Winnipeg Aurora,Winnipeg,WPG,66,3,58,5,11,0.083,1,100,345,-245,3,26,4,0,32,1,2,3,61
1,1,Chicago Syndicate,Chicago,CHI,66,56,5,5,117,0.886,55,315,140,175,27,3,3,29,2,2,1,4,62
2,7,Baltimore Platoon,Baltimore,BAP,66,52,12,2,106,0.803,47,272,152,120,26,6,1,26,6,1,5,1,62
3,15,Texas Renegades,Texas,TEX,66,49,12,5,103,0.780,44,266,145,121,20,9,4,29,3,1,5,3,62
4,0,Buffalo Stampede,Buffalo,BUF,66,50,16,0,100,0.758,47,302,187,115,25,8,0,25,8,0,3,0,62
5,2,Hamilton Steelhawks,Hamilton,HAM,66,46,13,7,99,0.750,46,294,155,139,26,4,3,20,9,4,0,5,62
6,13,Los Angeles Panthers,Los Angeles,LAP,66,42,22,2,86,0.652,37,243,189,54,23,9,1,19,13,1,5,1,62
7,6,Tampa Bay Barracuda,Tampa Bay,TBB,66,39,22,5,83,0.629,33,214,183,31,22,9,2,17,13,3,6,3,62
8,8,Calgary Dragons,Calgary,CGY,66,36,23,7,79,0.598,30,219,216,3,18,12,3,18,11,4,6,4,62
9,5,New England Wolfpack,New England,NEW,66,36,25,5,77,0.583,33,252,198,54,18,12,3,18,13,2,3,4,62
10,21,Philadelphia Forge,Philadelphia,PHI,66,32,25,9,73,0.553,31,231,199,32,18,12,3,14,13,6,1,5,62
11,3,Toronto North Stars,Toronto,TOR,66,32,29,5,69,0.523,28,195,177,18,15,16,2,17,13,3,4,2,62
12,19,Seattle Argonauts,Seattle,SEA,66,30,29,7,67,0.508,27,214,214,0,15,15,3,15,14,4,3,5,62
13,18,Atlanta Inferno,Atlanta,ATL,66,28,28,10,66,0.500,21,198,235,-37,13,16,4,15,12,6,7,8,62
14,12,San Francisco Pride,San Francisco,SFP,66,30,32,4,64,0.485,29,202,223,-21,17,14,2,13,18,2,1,4,62
15,10,Minnesota Monarchs,Minnesota,MIN,66,31,34,1,63,0.477,29,208,243,-35,16,16,1,15,18,0,2,1,62
16,9,Edmonton Blizzard,Edmonton,EDM,66,24,37,5,53,0.402,23,209,253,-44,13,19,1,11,18,4,1,4,62
17,14,New Orleans Specters,New Orleans,NOL,66,20,41,5,45,0.341,17,173,234,-61,9,21,3,11,20,2,3,4,62
18,20,Montreal Patriotes,Montreal,MTL,66,11,52,3,25,0.189,9,114,330,-216,7,25,1,4,27,2,2,1,62
19,4,Manhattan Rage,Manhattan,MAN,66,11,53,2,24,0.182,10,121,310,-189,6,25,2,5,28,0,1,1,62
20,11,Winnipeg Aurora,Winnipeg,WPG,66,5,60,1,11,0.083,3,95,354,-259,2,30,1,3,30,0,2,1,62
1,7,Baltimore Platoon,Baltimore,BAP,66,54,11,1,109,0.826,50,308,149,159,29,3,1,25,8,0,4,0,63
2,2,Hamilton Steelhawks,Hamilton,HAM,66,50,13,3,103,0.780,49,275,140,135,26,5,2,24,8,1,1,2,63
3,15,Texas Renegades,Texas,TEX,66,48,14,4,100,0.758,45,258,125,133,24,6,3,24,8,1,3,3,63
4,1,Chicago Syndicate,Chicago,CHI,66,47,16,3,97,0.735,45,255,150,105,23,9,1,24,7,2,2,3,63
5,6,Tampa Bay Barracuda,Tampa Bay,TBB,66,48,17,1,97,0.735,41,243,158,85,23,10,0,25,7,1,7,0,63
6,19,Seattle Argonauts,Seattle,SEA,66,43,17,6,92,0.697,40,235,166,69,20,10,3,23,7,3,3,4,63
7,12,San Francisco Pride,San Francisco,SFP,66,40,21,5,85,0.644,39,252,186,66,19,13,1,21,8,4,1,2,63
8,0,Buffalo Stampede,Buffalo,BUF,66,38,21,7,83,0.629,33,210,177,33,25,7,1,13,14,6,5,5,63
9,18,Atlanta Inferno,Atlanta,ATL,66,38,22,6,82,0.621,34,255,201,54,23,9,1,15,13,5,4,4,63
10,3,Toronto North Stars,Toronto,TOR,66,36,22,8,80,0.606,32,204,183,21,21,9,3,15,13,5,4,6,63
11,21,Philadelphia Forge,Philadelphia,PHI,66,34,22,10,78,0.591,33,235,202,33,19,10,4,15,12,6,1,5,63
12,13,Los Angeles Panthers,Los Angeles,LAP,66,36,24,6,78,0.591,32,227,202,25,21,10,2,15,14,4,4,4,63
13,14,New Orleans Specters,New Orleans,NOL,66,30,32,4,64,0.485,22,177,237,-60,17,13,3,13,19,1,8,4,63
14,8,Calgary Dragons,Calgary,CGY,66,25,37,4,54,0.409,20,155,212,-57,18,14,1,7,23,3,5,4,63
15,9,Edmonton Blizzard,Edmonton,EDM,66,21,37,8,50,0.379,20,186,224,-38,13,14,6,8,23,2,1,7,63
16,5,New England Wolfpack,New England,NEW,66,20,42,4,44,0.333,16,159,263,-104,12,19,2,8,23,2,4,4,63
17,10,Minnesota Monarchs,Minnesota,MIN,66,18,42,6,42,0.318,15,174,267,-93,11,18,4,7,24,2,3,5,63
18,20,Montreal Patriotes,Montreal,MTL,66,14,48,4,32,0.242,10,116,274,-158,6,26,1,8,22,3,4,3,63
19,11,Winnipeg Aurora,Winnipeg,WPG,66,11,52,3,25,0.189,9,127,336,-209,7,24,2,4,28,1,2,2,63
20,4,Manhattan Rage,Manhattan,MAN,66,9,54,3,21,0.159,7,108,307,-199,6,25,2,3,29,1,2,1,63
1,1,Chicago Syndicate,Chicago,CHI,66,52,14,0,104,0.788,48,244,155,89,27,6,0,25,8,0,4,0,64
2,15,Texas Renegades,Texas,TEX,66,47,12,7,101,0.765,44,250,159,91,28,4,1,19,8,6,3,5,64
3,7,Baltimore Platoon,Baltimore,BAP,66,46,16,4,96,0.727,43,286,175,111,25,7,1,21,9,3,3,2,64
4,13,Los Angeles Panthers,Los Angeles,LAP,66,44,14,8,96,0.727,42,264,175,89,23,7,3,21,7,5,2,4,64
5,0,Buffalo Stampede,Buffalo,BUF,66,47,17,2,96,0.727,41,265,169,96,24,8,1,23,9,1,6,0,64
6,18,Atlanta Inferno,Atlanta,ATL,66,41,22,3,85,0.644,38,275,199,76,22,9,2,19,13,1,3,2,64
7,6,Tampa Bay Barracuda,Tampa Bay,TBB,66,39,22,5,83,0.629,38,253,207,46,23,6,4,16,16,1,1,4,64
8,21,Philadelphia Forge,Philadelphia,PHI,66,38,23,5,81,0.614,35,249,202,47,22,9,2,16,14,3,3,5,64
9,12,San Francisco Pride,San Francisco,SFP,66,38,23,5,81,0.614,35,221,193,28,23,8,2,15,15,3,3,5,64
10,2,Hamilton Steelhawks,Hamilton,HAM,66,37,22,7,81,0.614,34,261,221,40,20,10,3,17,12,4,3,3,64
11,14,New Orleans Specters,New Orleans,NOL,66,36,25,5,77,0.583,29,213,201,12,19,11,3,17,14,2,7,5,64
12,19,Seattle Argonauts,Seattle,SEA,66,35,25,6,76,0.576,33,248,216,32,18,14,1,17,11,5,2,3,64
13,9,Edmonton Blizzard,Edmonton,EDM,66,28,34,4,60,0.455,25,200,226,-26,14,15,4,14,19,0,3,2,64
14,11,Winnipeg Aurora,Winnipeg,WPG,66,23,36,7,53,0.402,20,209,259,-50,12,18,3,11,18,4,3,6,64
15,20,Montreal Patriotes,Montreal,MTL,66,23,39,4,50,0.379,22,178,256,-78,12,19,2,11,20,2,1,2,64
16,8,Calgary Dragons,Calgary,CGY,66,23,39,4,50,0.379,21,177,252,-75,12,20,1,11,19,3,2,2,64
17,10,Minnesota Monarchs,Minnesota,MIN,66,22,43,1,45,0.341,19,143,254,-111,13,20,0,9,23,1,3,0,64
18,3,Toronto North Stars,Toronto,TOR,66,19,43,4,42,0.318,17,191,272,-81,9,22,2,10,21,2,2,4,64
19,5,New England Wolfpack,New England,NEW,66,12,49,5,29,0.220,8,128,283,-155,6,24,3,6,25,2,4,3,64
20,4,Manhattan Rage,Manhattan,MAN,66,10,55,1,21,0.159,10,124,305,-181,5,28,0,5,27,1,0,1,64
1,13,Los Angeles Panthers,Los Angeles,LAP,66,50,14,2,102,0.773,45,263,175,88,26,6,1,24,8,1,5,1,65
2,1,Chicago Syndicate,Chicago,CHI,66,47,17,2,96,0.727,45,278,173,105,25,7,1,22,10,1,2,2,65
3,12,San Francisco Pride,San Francisco,SFP,66,45,18,3,93,0.705,39,244,178,66,23,10,0,22,8,3,6,1,65
4,19,Seattle Argonauts,Seattle,SEA,66,43,19,4,90,0.682,40,266,197,69,20,9,4,23,10,0,3,4,65
5,6,Tampa Bay Barracuda,Tampa Bay,TBB,66,44,21,1,89,0.674,44,272,178,94,24,9,0,20,12,1,0,1,65
6,0,Buffalo Stampede,Buffalo,BUF,66,42,19,5,89,0.674,39,262,185,77,26,4,3,16,15,2,3,3,65
7,7,Baltimore Platoon,Baltimore,BAP,66,43,21,2,88,0.667,39,274,207,67,23,8,2,20,13,0,4,2,65
8,11,Winnipeg Aurora,Winnipeg,WPG,66,41,19,6,88,0.667,37,246,179,67,19,10,4,22,9,2,4,5,65
9,18,Atlanta Inferno,Atlanta,ATL,66,41,20,5,87,0.659,40,291,192,99,20,10,3,21,10,2,1,3,65
10,21,Philadelphia Forge,Philadelphia,PHI,66,39,22,5,83,0.629,39,269,208,61,22,8,3,17,14,2,0,3,65
11,3,Toronto North Stars,Toronto,TOR,66,38,23,5,81,0.614,37,224,213,11,23,7,3,15,16,2,1,5,65
12,2,Hamilton Steelhawks,Hamilton,HAM,66,37,27,2,76,0.576,34,216,193,23,20,13,0,17,14,2,3,1,65
13,14,New Orleans Specters,New Orleans,NOL,66,31,29,6,68,0.515,30,202,211,-9,16,13,4,15,16,2,1,4,65
14,9,Edmonton Blizzard,Edmonton,EDM,66,28,32,6,62,0.470,24,215,251,-36,15,16,2,13,16,4,4,2,65
15,15,Texas Renegades,Texas,TEX,66,23,38,5,51,0.386,20,183,269,-86,12,17,4,11,21,1,3,5,65
16,8,Calgary Dragons,Calgary,CGY,66,17,44,5,39,0.295,16,154,286,-132,10,19,4,7,25,1,1,2,65
17,4,Manhattan Rage,Manhattan,MAN,66,17,44,5,39,0.295,13,183,279,-96,8,22,3,9,22,2,4,3,65
18,20,Montreal Patriotes,Montreal,MTL,66,16,44,6,38,0.288,14,166,273,-107,11,19,3,5,25,3,2,2,65
19,5,New England Wolfpack,New England,NEW,66,12,51,3,27,0.205,11,143,310,-167,8,23,2,4,28,1,1,0,65
20,10,Minnesota Monarchs,Minnesota,MIN,66,6,59,1,13,0.098,4,112,306,-194,2,31,0,4,28,1,2,1,65
1,18,Atlanta Inferno,Atlanta,ATL,66,50,14,2,102,0.773,48,296,163,133,29,3,1,21,11,1,2,2,66
2,1,Chicago Syndicate,Chicago,CHI,66,45,15,6,96,0.727,42,294,193,101,25,6,2,20,9,4,3,2,66
3,13,Los Angeles Panthers,Los Angeles,LAP,66,45,17,4,94,0.712,44,321,197,124,26,6,1,19,11,3,1,3,66
4,12,San Francisco Pride,San Francisco,SFP,66,43,18,5,91,0.689,40,306,204,102,27,5,1,16,13,4,3,3,66
5,14,New Orleans Specters,New Orleans,NOL,66,40,19,7,87,0.659,39,250,192,58,23,7,3,17,12,4,1,5,66
6,0,Buffalo Stampede,Buffalo,BUF,66,42,22,2,86,0.652,40,283,203,80,23,9,1,19,13,1,2,1,66
7,19,Seattle Argonauts,Seattle,SEA,66,40,20,6,86,0.652,37,253,202,51,24,7,2,16,13,4,3,2,66
8,20,Montreal Patriotes,Montreal,MTL,66,39,22,5,83,0.629,39,276,221,55,22,10,1,17,12,4,0,3,66
9,4,Manhattan Rage,Manhattan,MAN,66,38,22,6,82,0.621,36,254,208,46,24,6,3,14,16,3,2,1,66
10,3,Toronto North Stars,Toronto,TOR,66,38,26,2,78,0.591,36,260,229,31,23,10,0,15,16,2,2,2,66
11,11,Winnipeg Aurora,Winnipeg,WPG,66,38,27,1,77,0.583,34,278,241,37,22,10,1,16,17,0,4,0,66
12,6,Tampa Bay Barracuda,Tampa Bay,TBB,66,32,25,9,73,0.553,31,281,247,34,18,11,4,14,14,5,1,2,66
13,21,Philadelphia Forge,Philadelphia,PHI,66,30,30,6,66,0.500,26,210,241,-31,18,14,1,12,16,5,4,1,66
14,8,Calgary Dragons,Calgary,CGY,66,31,32,3,65,0.492,29,224,247,-23,21,11,1,10,21,2,2,1,66
15,15,Texas Renegades,Texas,TEX,66,24,34,8,56,0.424,23,217,269,-52,12,17,4,12,17,4,1,4,66
16,2,Hamilton Steelhawks,Hamilton,HAM,66,25,36,5,55,0.417,23,256,300,-44,15,15,3,10,21,2,2,4,66
17,7,Baltimore Platoon,Baltimore,BAP,66,22,37,7,51,0.386,20,203,291,-88,16,15,2,6,22,5,2,1,66
18,5,New England Wolfpack,New England,NEW,66,22,41,3,47,0.356,20,199,293,-94,13,17,3,9,24,0,2,0,66
19,10,Minnesota Monarchs,Minnesota,MIN,66,11,52,3,25,0.189,9,160,360,-200,6,26,1,5,26,2,2,2,66
20,9,Edmonton Blizzard,Edmonton,EDM,66,5,59,2,12,0.091,5,161,481,-320,4,27,2,1,32,0,0,0,66
1,11,Winnipeg Aurora,Winnipeg,WPG,66,50,13,3,103,0.780,47,287,166,121,27,5,1,23,8,2,3,2,67
2,3,Toronto North Stars,Toronto,TOR,66,47,16,3,97,0.735,46,320,186,134,23,7,3,24,9,0,1,2,67
3,18,Atlanta Inferno,Atlanta,ATL,66,48,17,1,97,0.735,45,296,181,115,22,10,1,26,7,0,3,0,67
4,8,Calgary Dragons,Calgary,CGY,66,42,17,7,91,0.689,38,286,218,68,23,7,3,19,10,4,4,4,67
5,19,Seattle Argonauts,Seattle,SEA,66,43,19,4,90,0.682,40,281,198,83,22,8,3,21,11,1,3,1,67
6,14,New Orleans Specters,New Orleans,NOL,66,43,21,2,88,0.667,43,276,207,69,27,6,0,16,15,2,0,1,67
7,12,San Francisco Pride,San Francisco,SFP,66,41,23,2,84,0.636,38,260,211,49,25,7,1,16,16,1,3,1,67
8,21,Philadelphia Forge,Philadelphia,PHI,66,37,24,5,79,0.598,34,254,201,53,22,9,2,15,15,3,3,4,67
9,4,Manhattan Rage,Manhattan,MAN,66,36,23,7,79,0.598,34,256,219,37,18,11,4,18,12,3,2,4,67
10,13,Los Angeles Panthers,Los Angeles,LAP,66,38,26,2,78,0.591,32,253,240,13,20,12,1,18,14,1,6,2,67
11,1,Chicago Syndicate,Chicago,CHI,66,34,23,9,77,0.583,31,240,200,40,23,5,5,11,18,4,3,3,67
12,0,Buffalo Stampede,Buffalo,BUF,66,35,27,4,74,0.561,35,275,224,51,21,10,2,14,17,2,0,1,67
13,20,Montreal Patriotes,Montreal,MTL,66,34,27,5,73,0.553,33,278,234,44,22,9,2,12,18,3,1,3,67
14,5,New England Wolfpack,New England,NEW,66,30,35,1,61,0.462,27,201,255,-54,18,14,1,12,21,0,3,1,67
15,6,Tampa Bay Barracuda,Tampa Bay,TBB,66,26,33,7,59,0.447,24,247,269,-22,16,14,3,10,19,4,2,5,67
16,9,Edmonton Blizzard,Edmonton,EDM,66,19,38,9,47,0.356,17,176,276,-100,12,16,5,7,22,4,2,5,67
17,15,Texas Renegades,Texas,TEX,66,20,44,2,42,0.318,18,187,299,-112,15,16,2,5,28,0,2,2,67
18,7,Baltimore Platoon,Baltimore,BAP,66,19,45,2,40,0.303,17,189,309,-120,10,21,2,9,24,0,2,0,67
19,2,Hamilton Steelhawks,Hamilton,HAM,66,10,51,5,25,0.189,9,149,410,-261,7,24,2,3,27,3,1,2,67
20,10,Minnesota Monarchs,Minnesota,MIN,66,8,52,6,22,0.167,7,102,310,-208,4,28,1,4,24,5,1,2,67
1,19,Seattle Argonauts,Seattle,SEA,66,54,9,3,111,0.841,53,318,150,168,28,4,1,26,5,2,1,2,68
2,11,Winnipeg Aurora,Winnipeg,WPG,66,54,10,2,110,0.833,53,305,150,155,27,5,1,27,5,1,1,2,68
3,18,Atlanta Inferno,Atlanta,ATL,66,51,13,2,104,0.788,50,274,159,115,29,3,1,22,10,1,1,2,68
4,3,Toronto North Stars,Toronto,TOR,66,46,16,4,96,0.727,40,342,238,104,25,7,1,21,9,3,6,1,68
5,0,Buffalo Stampede,Buffalo,BUF,66,45,19,2,92,0.697,43,307,207,100,25,8,0,20,11,2,2,2,68
6,1,Chicago Syndicate,Chicago,CHI,66,44,18,4,92,0.697,40,290,199,91,22,8,3,22,10,1,4,1,68
7,21,Philadelphia Forge,Philadelphia,PHI,66,44,20,2,90,0.682,43,293,198,95,25,8,0,19,12,2,1,0,68
8,20,Montreal Patriotes,Montreal,MTL,66,40,19,7,87,0.659,37,269,211,58,25,4,4,15,15,3,3,2,68
9,4,Manhattan Rage,Manhattan,MAN,66,40,22,4,84,0.636,37,284,236,48,24,8,1,16,14,3,3,3,68
10,8,Calgary Dragons,Calgary,CGY,66,37,21,8,82,0.621,34,259,210,49,22,9,2,15,12,6,3,3,68
11,14,New Orleans Specters,New Orleans,NOL,66,32,29,5,69,0.523,29,189,197,-8,17,14,2,15,15,3,3,3,68
12,5,New England Wolfpack,New England,NEW,66,30,28,8,68,0.515,29,263,248,15,21,11,1,9,17,7,1,3,68
13,9,Edmonton Blizzard,Edmonton,EDM,66,30,31,5,65,0.492,28,192,226,-34,20,10,3,10,21,2,2,2,68
14,7,Baltimore Platoon,Baltimore,BAP,66,19,40,7,45,0.341,17,177,283,-106,12,15,6,7,25,1,2,3,68
15,15,Texas Renegades,Texas,TEX,66,18,44,4,40,0.303,16,170,299,-129,11,20,2,7,24,2,2,2,68
16,13,Los Angeles Panthers,Los Angeles,LAP,66,16,44,6,38,0.288,15,195,282,-87,11,17,5,5,27,1,1,4,68
17,6,Tampa Bay Barracuda,Tampa Bay,TBB,66,16,45,5,37,0.280,15,192,325,-133,10,20,3,6,25,2,1,1,68
18,10,Minnesota Monarchs,Minnesota,MIN,66,15,47,4,34,0.258,14,156,294,-138,7,23,3,8,24,1,1,2,68
19,12,San Francisco Pride,San Francisco,SFP,66,15,47,4,34,0.258,12,177,343,-166,10,22,1,5,25,3,3,3,68
20,2,Hamilton Steelhawks,Hamilton,HAM,66,14,50,2,30,0.227,12,176,373,-197,8,24,1,6,26,1,2,2,68
1,11,Winnipeg Aurora,Winnipeg,WPG,66,52,12,2,106,0.803,50,304,171,133,30,3,0,22,9,2,2,1,69
2,19,Seattle Argonauts,Seattle,SEA,66,50,13,3,103,0.780,48,295,148,147,27,4,2,23,9,1,2,2,69
3,20,Montreal Patriotes,Montreal,MTL,66,50,15,1,101,0.765,49,299,169,130,25,7,1,25,8,0,1,0,69
4,18,Atlanta Inferno,Atlanta,ATL,66,46,16,4,96,0.727,46,292,203,89,24,7,2,22,9,2,0,2,69
5,21,Philadelphia Forge,Philadelphia,PHI,66,45,16,5,95,0.720,42,297,188,109,24,9,0,21,7,5,3,3,69
6,5,New England Wolfpack,New England,NEW,66,45,17,4,94,0.712,44,283,178,105,24,8,1,21,9,3,1,2,69
7,0,Buffalo Stampede,Buffalo,BUF,66,44,19,3,91,0.689,44,289,190,99,25,6,2,19,13,1,0,3,69
8,8,Calgary Dragons,Calgary,CGY,66,43,19,4,90,0.682,41,264,198,66,22,8,3,21,11,1,2,1,69
9,1,Chicago Syndicate,Chicago,CHI,66,43,19,4,90,0.682,40,301,197,104,24,7,2,19,12,2,3,3,69
10,14,New Orleans Specters,New Orleans,NOL,66,42,22,2,86,0.652,37,268,213,55,23,9,1,19,13,1,5,0,69
11,4,Manhattan Rage,Manhattan,MAN,66,39,20,7,85,0.644,37,269,190,79,23,7,3,16,13,4,2,4,69
12,9,Edmonton Blizzard,Edmonton,EDM,66,32,27,7,71,0.538,31,240,227,13,18,12,3,14,15,4,1,3,69
13,15,Texas Renegades,Texas,TEX,66,23,38,5,51,0.386,19,188,287,-99,14,16,3,9,22,2,4,2,69
14,6,Tampa Bay Barracuda,Tampa Bay,TBB,66,19,39,8,46,0.348,15,177,287,-110,12,17,4,7,22,4,4,2,69
15,10,Minnesota Monarchs,Minnesota,MIN,66,17,45,4,38,0.288,16,164,316,-152,10,22,1,7,23,3,1,2,69
16,13,Los Angeles Panthers,Los Angeles,LAP,66,17,48,1,35,0.265,15,158,266,-108,9,24,0,8,24,1,2,0,69
17,2,Hamilton Steelhawks,Hamilton,HAM,66,15,48,3,33,0.250,15,172,329,-157,9,21,3,6,27,0,0,0,69
18,12,San Francisco Pride,San Francisco,SFP,66,13,48,5,31,0.235,13,196,356,-160,9,20,4,4,28,1,0,2,69
19,3,Toronto North Stars,Toronto,TOR,66,13,50,3,29,0.220,11,127,319,-192,7,23,3,6,27,0,2,3,69
20,7,Baltimore Platoon,Baltimore,BAP,66,12,50,4,28,0.212,11,146,297,-151,9,23,1,3,27,3,1,1,69
1,21,Philadelphia Forge,Philadelphia,PHI,66,57,8,1,115,0.871,54,369,176,193,28,5,0,29,3,1,3,1,70
2,11,Winnipeg Aurora,Winnipeg,WPG,66,53,11,2,108,0.818,53,386,194,192,27,5,1,26,6,1,0,1,70
3,19,Seattle Argonauts,Seattle,SEA,66,46,14,6,98,0.742,45,268,180,88,25,5,3,21,9,3,1,3,70
4,20,Montreal Patriotes,Montreal,MTL,66,46,17,3,95,0.720,46,295,194,101,24,7,2,22,10,1,0,2,70
5,18,Atlanta Inferno,Atlanta,ATL,66,47,19,0,94,0.712,46,336,199,137,23,10,0,24,9,0,1,0,70
6,5,New England Wolfpack,New England,NEW,66,41,19,6,88,0.667,39,306,229,77,19,9,5,22,10,1,2,3,70
7,8,Calgary Dragons,Calgary,CGY,66,41,23,2,84,0.636,40,268,203,65,21,12,0,20,11,2,1,0,70
8,1,Chicago Syndicate,Chicago,CHI,66,39,23,4,82,0.621,34,254,217,37,21,11,1,18,12,3,5,1,70
9,0,Buffalo Stampede,Buffalo,BUF,66,37,24,5,79,0.598,37,291,219,72,20,10,3,17,14,2,0,2,70
10,14,New Orleans Specters,New Orleans,NOL,66,35,25,6,76,0.576,30,255,231,24,21,9,3,14,16,3,5,3,70
11,9,Edmonton Blizzard,Edmonton,EDM,66,36,28,2,74,0.561,34,281,243,38,21,12,0,15,16,2,2,0,70
12,15,Texas Renegades,Texas,TEX,66,30,33,3,63,0.477,29,222,264,-42,18,14,1,12,19,2,1,0,70
13,2,Hamilton Steelhawks,Hamilton,HAM,66,26,35,5,57,0.432,25,237,311,-74,12,16,5,14,19,0,1,2,70
14,7,Baltimore Platoon,Baltimore,BAP,66,25,37,4,54,0.409,22,197,278,-81,13,18,2,12,19,2,3,4,70
15,10,Minnesota Monarchs,Minnesota,MIN,66,23,39,4,50,0.379,23,222,303,-81,15,17,1,8,22,3,0,2,70
16,4,Manhattan Rage,Manhattan,MAN,66,20,43,3,43,0.326,20,245,363,-118,10,20,3,10,23,0,0,0,70
17,12,San Francisco Pride,San Francisco,SFP,66,21,45,0,42,0.318,19,195,297,-102,14,19,0,7,26,0,2,0,70
18,13,Los Angeles Panthers,Los Angeles,LAP,66,17,41,8,42,0.318,17,204,334,-130,9,22,2,8,19,6,0,3,70
19,6,Tampa Bay Barracuda,Tampa Bay,TBB,66,14,51,1,29,0.220,13,173,333,-160,8,25,0,6,26,1,1,0,70
20,3,Toronto North Stars,Toronto,TOR,66,6,57,3,15,0.114,6,148,384,-236,4,27,2,2,30,1,0,1,70
1,11,Winnipeg Aurora,Winnipeg,WPG,66,54,9,3,111,0.841,52,355,184,171,28,4,1,26,5,2,2,2,71
2,5,New England Wolfpack,New England,NEW,66,50,13,3,103,0.780,50,339,179,160,26,5,2,24,8,1,0,2,71
3,20,Montreal Patriotes,Montreal,MTL,66,50,15,1,101,0.765,48,310,178,132,27,5,1,23,10,0,2,0,71
4,21,Philadelphia Forge,Philadelphia,PHI,66,48,17,1,97,0.735,46,362,210,152,27,6,0,21,11,1,2,1,71
5,0,Buffalo Stampede,Buffalo,BUF,66,45,17,4,94,0.712,44,297,201,96,27,5,1,18,12,3,1,0,71
6,9,Edmonton Blizzard,Edmonton,EDM,66,44,19,3,91,0.689,44,326,205,121,25,7,1,19,12,2,0,0,71
7,18,Atlanta Inferno,Atlanta,ATL,66,41,22,3,85,0.644,38,269,217,52,23,8,2,18,14,1,3,3,71
8,1,Chicago Syndicate,Chicago,CHI,66,36,25,5,77,0.583,35,285,255,30,22,7,4,14,18,1,1,3,71
9,14,New Orleans Specters,New Orleans,NOL,66,37,26,3,77,0.583,34,240,216,24,23,9,1,14,17,2,3,2,71
10,7,Baltimore Platoon,Baltimore,BAP,66,35,26,5,75,0.568,33,272,267,5,20,11,2,15,15,3,2,3,71
11,2,Hamilton Steelhawks,Hamilton,HAM,66,33,31,2,68,0.515,31,269,294,-25,17,15,1,16,16,1,2,1,71
12,13,Los Angeles Panthers,Los Angeles,LAP,66,30,33,3,63,0.477,28,222,280,-58,17,15,1,13,18,2,2,3,71
13,15,Texas Renegades,Texas,TEX,66,29,32,5,63,0.477,28,214,240,-26,17,14,2,12,18,3,1,1,71
14,19,Seattle Argonauts,Seattle,SEA,66,25,33,8,58,0.439,24,207,245,-38,15,14,4,10,19,4,1,4,71
15,12,San Francisco Pride,San Francisco,SFP,66,23,34,9,55,0.417,21,234,277,-43,16,13,4,7,21,5,2,4,71
16,10,Minnesota Monarchs,Minnesota,MIN,66,25,37,4,54,0.409,22,214,281,-67,16,17,0,9,20,4,3,2,71
17,6,Tampa Bay Barracuda,Tampa Bay,TBB,66,21,39,6,48,0.364,19,193,290,-97,14,18,1,7,21,5,2,2,71
18,8,Calgary Dragons,Calgary,CGY,66,20,43,3,43,0.326,16,207,301,-94,11,22,0,9,21,3,4,1,71
19,3,Toronto North Stars,Toronto,TOR,66,10,56,0,20,0.152,9,151,384,-233,6,27,0,4,29,0,1,0,71
20,4,Manhattan Rage,Manhattan,MAN,66,4,58,4,12,0.091,3,154,416,-262,4,29,0,0,29,4,1,1,71
1,5,New England Wolfpack,New England,NEW,66,51,15,0,102,0.773,51,364,216,148,28,5,0,23,10,0,0,0,72
2,11,Winnipeg Aurora,Winnipeg,WPG,66,46,17,3,95,0.720,46,343,213,130,32,1,0,14,16,3,0,2,72
3,1,Chicago Syndicate,Chicago,CHI,66,47,18,1,95,0.720,44,329,215,114,28,5,0,19,13,1,3,0,72
4,9,Edmonton Blizzard,Edmonton,EDM,66,46,18,2,94,0.712,45,340,215,125,26,6,1,20,12,1,1,0,72
5,20,Montreal Patriotes,Montreal,MTL,66,45,18,3,93,0.705,42,304,200,104,24,9,0,21,9,3,3,2,72
6,21,Philadelphia Forge,Philadelphia,PHI,66,43,16,7,93,0.705,42,332,207,125,25,6,2,18,10,5,1,4,72
7,0,Buffalo Stampede,Buffalo,BUF,66,43,21,2,88,0.667,41,302,240,62,22,11,0,21,10,2,2,1,72
8,15,Texas Renegades,Texas,TEX,66,41,19,6,88,0.667,39,260,219,41,27,5,1,14,14,5,2,4,72
9,18,Atlanta Inferno,Atlanta,ATL,66,39,23,4,82,0.621,38,279,201,78,19,12,2,20,11,2,1,2,72
10,7,Baltimore Platoon,Baltimore,BAP,66,36,26,4,76,0.576,33,271,264,7,23,9,1,13,17,3,3,3,72
11,13,Los Angeles Panthers,Los Angeles,LAP,66,35,29,2,72,0.545,34,249,249,0,21,10,2,14,19,0,1,2,72
12,2,Hamilton Steelhawks,Hamilton,HAM,66,31,31,4,66,0.500,29,296,306,-10,20,12,1,11,19,3,2,2,72
13,12,San Francisco Pride,San Francisco,SFP,66,24,36,6,54,0.409,24,263,313,-50,17,14,2,7,22,4,0,1,72
14,19,Seattle Argonauts,Seattle,SEA,66,26,38,2,54,0.409,23,188,278,-90,18,14,1,8,24,1,3,0,72
15,14,New Orleans Specters,New Orleans,NOL,66,23,40,3,49,0.371,20,203,274,-71,13,19,1,10,21,2,3,0,72
16,8,Calgary Dragons,Calgary,CGY,66,20,39,7,47,0.356,20,200,306,-106,14,15,4,6,24,3,0,2,72
17,10,Minnesota Monarchs,Minnesota,MIN,66,22,43,1,45,0.341,21,212,287,-75,14,19,0,8,24,1,1,0,72
18,6,Tampa Bay Barracuda,Tampa Bay,TBB,66,20,42,4,44,0.333,20,231,307,-76,11,19,3,9,23,1,0,1,72
19,3,Toronto North Stars,Toronto,TOR,66,14,48,4,32,0.242,12,189,358,-169,8,23,2,6,25,2,2,3,72
20,4,Manhattan Rage,Manhattan,MAN,66,8,56,2,18,0.136,7,132,419,-287,5,28,0,3,28,2,1,0,72
1,5,New England Wolfpack,New England,NEW,66,53,11,2,108,0.818,51,377,173,204,28,4,1,25,7,1,2,1,73
2,21,Philadelphia Forge,Philadelphia,PHI,66,50,14,2,102,0.773,49,365,212,153,26,7,0,24,7,2,1,1,73
3,9,Edmonton Blizzard,Edmonton,EDM,66,50,15,1,101,0.765,50,395,188,207,28,5,0,22,10,1,0,0,73
4,0,Buffalo Stampede,Buffalo,BUF,66,47,15,4,98,0.742,46,303,211,92,26,6,1,21,9,3,1,2,73
5,11,Winnipeg Aurora,Winnipeg,WPG,66,48,17,1,97,0.735,47,355,202,153,25,8,0,23,9,1,1,1,73
6,18,Atlanta Inferno,Atlanta,ATL,66,45,21,0,90,0.682,45,341,227,114,26,7,0,19,14,0,0,0,73
7,7,Baltimore Platoon,Baltimore,BAP,66,37,25,4,78,0.591,36,292,245,47,21,10,2,16,15,2,1,4,73
8,2,Hamilton Steelhawks,Hamilton,HAM,66,37,26,3,77,0.583,36,320,273,47,19,13,1,18,13,2,1,0,73
9,15,Texas Renegades,Texas,TEX,66,35,26,5,75,0.568,34,268,250,18,22,8,3,13,18,2,1,2,73
10,13,Los Angeles Panthers,Los Angeles,LAP,66,36,28,2,74,0.561,34,283,251,32,22,10,1,14,18,1,2,1,73
11,1,Chicago Syndicate,Chicago,CHI,66,33,29,4,70,0.530,32,275,253,22,20,11,2,13,18,2,1,1,73
12,10,Minnesota Monarchs,Minnesota,MIN,66,33,30,3,69,0.523,31,284,281,3,19,13,1,14,17,2,2,0,73
13,14,New Orleans Specters,New Orleans,NOL,66,28,33,5,61,0.462,28,226,265,-39,15,16,2,13,17,3,0,1,73
14,12,San Francisco Pride,San Francisco,SFP,66,24,37,5,53,0.402,23,246,343,-97,16,14,3,8,23,2,1,1,73
15,6,Tampa Bay Barracuda,Tampa Bay,TBB,66,25,40,1,51,0.386,25,227,323,-96,13,19,1,12,21,0,0,1,73
16,3,Toronto North Stars,Toronto,TOR,66,22,39,5,49,0.371,20,222,332,-110,11,20,2,11,19,3,2,2,73
17,8,Calgary Dragons,Calgary,CGY,66,22,41,3,47,0.356,21,203,334,-131,12,18,3,10,23,0,1,3,73
18,19,Seattle Argonauts,Seattle,SEA,66,15,48,3,33,0.250,13,162,312,-150,10,22,1,5,26,2,2,1,73
19,20,Montreal Patriotes,Montreal,MTL,66,10,54,2,22,0.167,9,130,341,-211,6,26,1,4,28,1,1,1,73
20,4,Manhattan Rage,Manhattan,MAN,66,10,55,1,21,0.159,7,184,442,-258,7,26,0,3,29,1,3,0,73
1,9,Edmonton Blizzard,Edmonton,EDM,66,52,13,1,105,0.795,51,381,188,193,29,3,1,23,10,0,1,0,74
2,0,Buffalo Stampede,Buffalo,BUF,66,46,16,4,96,0.727,42,339,206,133,27,3,3,19,13,1,4,1,74
3,21,Philadelphia Forge,Philadelphia,PHI,66,44,17,5,93,0.705,42,346,204,142,26,6,1,18,11,4,2,4,74
4,18,Atlanta Inferno,Atlanta,ATL,66,42,19,5,89,0.674,41,334,237,97,23,6,4,19,13,1,1,0,74
5,7,Baltimore Platoon,Baltimore,BAP,66,41,18,7,89,0.674,38,318,222,96,22,8,3,19,10,4,3,3,74
6,15,Texas Renegades,Texas,TEX,66,41,20,5,87,0.659,40,277,201,76,23,8,2,18,12,3,1,3,74
7,1,Chicago Syndicate,Chicago,CHI,66,41,23,2,84,0.636,38,274,256,18,23,8,2,18,15,0,3,0,74
8,13,Los Angeles Panthers,Los Angeles,LAP,66,40,22,4,84,0.636,38,330,253,77,25,6,2,15,16,2,2,3,74
9,5,New England Wolfpack,New England,NEW,66,40,22,4,84,0.636,38,314,243,71,24,9,0,16,13,4,2,2,74
10,11,Winnipeg Aurora,Winnipeg,WPG,66,38,24,4,80,0.606,34,289,223,66,24,7,2,14,17,2,4,2,74
11,6,Tampa Bay Barracuda,Tampa Bay,TBB,66,36,27,3,75,0.568,33,304,287,17,20,11,2,16,16,1,3,2,74
12,14,New Orleans Specters,New Orleans,NOL,66,34,27,5,73,0.553,33,263,255,8,18,10,5,16,17,0,1,3,74
13,2,Hamilton Steelhawks,Hamilton,HAM,66,32,28,6,70,0.530,31,310,294,16,16,13,4,16,15,2,1,2,74
14,12,San Francisco Pride,San Francisco,SFP,66,31,30,5,67,0.508,30,286,262,24,21,9,3,10,21,2,1,2,74
15,3,Toronto North Stars,Toronto,TOR,66,30,33,3,63,0.477,29,283,341,-58,14,17,2,16,16,1,1,1,74
16,10,Minnesota Monarchs,Minnesota,MIN,66,27,36,3,57,0.432,26,287,290,-3,18,14,1,9,22,2,1,1,74
17,8,Calgary Dragons,Calgary,CGY,66,24,40,2,50,0.379,23,225,328,-103,18,15,0,6,25,2,1,1,74
18,4,Manhattan Rage,Manhattan,MAN,66,10,55,1,21,0.159,9,187,475,-288,6,26,1,4,29,0,1,0,74
19,19,Seattle Argonauts,Seattle,SEA,66,7,57,2,16,0.121,6,119,352,-233,5,27,1,2,30,1,1,2,74
20,20,Montreal Patriotes,Montreal,MTL,66,4,59,3,11,0.083,4,125,474,-349,3,29,1,1,30,2,0,2,74
1,9,Edmonton Blizzard,Edmonton,EDM,66,49,16,1,99,0.750,47,357,201,156,27,5,1,22,11,0,2,1,75
2,13,Los Angeles Panthers,Los Angeles,LAP,66,46,18,2,94,0.712,46,332,247,85,23,8,2,23,10,0,0,0,75
3,21,Philadelphia Forge,Philadelphia,PHI,66,45,17,4,94,0.712,45,362,225,137,25,8,0,20,9,4,0,2,75
4,15,Texas Renegades,Texas,TEX,66,45,17,4,94,0.712,44,292,190,102,26,7,0,19,10,4,1,1,75
5,7,Baltimore Platoon,Baltimore,BAP,66,43,19,4,90,0.682,42,324,238,86,25,7,1,18,12,3,1,0,75
6,5,New England Wolfpack,New England,NEW,66,42,22,2,86,0.652,41,339,252,87,24,7,2,18,15,0,1,1,75
7,11,Winnipeg Aurora,Winnipeg,WPG,66,41,22,3,85,0.644,39,262,198,64,23,8,2,18,14,1,2,1,75
8,0,Buffalo Stampede,Buffalo,BUF,66,40,23,3,83,0.629,39,290,219,71,21,11,1,19,12,2,1,0,75
9,2,Hamilton Steelhawks,Hamilton,HAM,66,39,22,5,83,0.629,38,328,262,66,25,7,1,14,15,4,1,2,75
10,18,Atlanta Inferno,Atlanta,ATL,66,38,24,4,80,0.606,38,298,251,47,23,8,2,15,16,2,0,1,75
11,12,San Francisco Pride,San Francisco,SFP,66,34,29,3,71,0.538,32,267,247,20,19,11,3,15,18,0,2,0,75
12,6,Tampa Bay Barracuda,Tampa Bay,TBB,66,34,30,2,70,0.530,34,309,254,55,18,13,2,16,17,0,0,1,75
13,14,New Orleans Specters,New Orleans,NOL,66,31,34,1,63,0.477,29,253,255,-2,19,14,0,12,20,1,2,1,75
14,1,Chicago Syndicate,Chicago,CHI,66,29,34,3,61,0.462,26,248,308,-60,17,15,1,12,19,2,3,1,75
15,10,Minnesota Monarchs,Minnesota,MIN,66,26,36,4,56,0.424,25,228,244,-16,15,16,2,11,20,2,1,3,75
16,8,Calgary Dragons,Calgary,CGY,66,25,39,2,52,0.394,24,201,276,-75,17,15,1,8,24,1,1,2,75
17,3,Toronto North Stars,Toronto,TOR,66,25,40,1,51,0.386,25,244,292,-48,15,17,1,10,23,0,0,1,75
18,4,Manhattan Rage,Manhattan,MAN,66,20,42,4,44,0.333,19,226,332,-106,11,22,0,9,20,4,1,1,75
19,19,Seattle Argonauts,Seattle,SEA,66,7,56,3,17,0.129,5,126,390,-264,6,25,2,1,31,1,2,1,75
20,20,Montreal Patriotes,Montreal,MTL,66,1,64,1,3,0.023,1,139,544,-405,1,32,0,0,32,1,0,1,75
1,7,Baltimore Platoon,Baltimore,BAP,66,52,11,3,107,0.811,51,309,186,123,28,5,0,24,6,3,1,2,76
2,12,San Francisco Pride,San Francisco,SFP,66,50,12,4,104,0.788,46,351,206,145,29,2,2,21,10,2,4,3,76
3,13,Los Angeles Panthers,Los Angeles,LAP,66,50,14,2,102,0.773,46,343,195,148,28,4,1,22,10,1,4,1,76
4,15,Texas Renegades,Texas,TEX,66,47,17,2,96,0.727,44,300,204,96,22,11,0,25,6,2,3,2,76
5,21,Philadelphia Forge,Philadelphia,PHI,66,41,23,2,84,0.636,40,291,221,70,24,9,0,17,14,2,1,1,76
6,14,New Orleans Specters,New Orleans,NOL,66,38,24,4,80,0.606,36,261,226,35,24,8,1,14,16,3,2,1,76
7,0,Buffalo Stampede,Buffalo,BUF,66,37,24,5,79,0.598,36,291,238,53,22,9,2,15,15,3,1,4,76
8,11,Winnipeg Aurora,Winnipeg,WPG,66,36,27,3,75,0.568,36,264,231,33,19,13,1,17,14,2,0,2,76
9,6,Tampa Bay Barracuda,Tampa Bay,TBB,66,33,26,7,73,0.553,30,281,254,27,17,13,3,16,13,4,3,0,76
10,5,New England Wolfpack,New England,NEW,66,32,29,5,69,0.523,31,287,260,27,18,12,3,14,17,2,1,1,76
11,2,Hamilton Steelhawks,Hamilton,HAM,66,31,29,6,68,0.515,29,285,281,4,18,13,2,13,16,4,2,4,76
12,4,Manhattan Rage,Manhattan,MAN,66,31,32,3,65,0.492,30,246,259,-13,22,11,0,9,21,3,1,1,76
13,10,Minnesota Monarchs,Minnesota,MIN,66,31,32,3,65,0.492,26,228,245,-17,17,14,2,14,18,1,5,3,76
14,18,Atlanta Inferno,Atlanta,ATL,66,31,33,2,64,0.485,31,249,254,-5,17,16,0,14,17,2,0,1,76
15,3,Toronto North Stars,Toronto,TOR,66,29,31,6,64,0.485,25,264,305,-41,18,11,4,11,20,2,4,2,76
16,8,Calgary Dragons,Calgary,CGY,66,27,35,4,58,0.439,23,242,315,-73,20,11,2,7,24,2,4,3,76
17,1,Chicago Syndicate,Chicago,CHI,66,22,37,7,51,0.386,21,235,317,-82,13,15,5,9,22,2,1,4,76
18,9,Edmonton Blizzard,Edmonton,EDM,66,17,44,5,39,0.295,16,236,347,-111,11,20,2,6,24,3,1,4,76
19,20,Montreal Patriotes,Montreal,MTL,66,14,48,4,32,0.242,12,168,405,-237,9,21,3,5,27,1,2,1,76
20,19,Seattle Argonauts,Seattle,SEA,66,11,53,2,24,0.182,9,141,323,-182,7,26,0,4,27,2,2,2,76
1,21,Philadelphia Forge,Philadelphia,PHI,66,51,10,5,107,0.811,50,356,206,150,28,2,3,23,8,2,1,4,77
2,12,San Francisco Pride,San Francisco,SFP,66,50,16,0,100,0.758,47,338,203,135,23,10,0,27,6,0,3,0,77
3,15,Texas Renegades,Texas,TEX,66,44,18,4,92,0.697,43,309,215,94,26,4,3,18,14,1,1,2,77
4,18,Atlanta Inferno,Atlanta,ATL,66,44,20,2,90,0.682,42,287,235,52,23,10,0,21,10,2,2,1,77
5,13,Los Angeles Panthers,Los Angeles,LAP,66,43,22,1,87,0.659,42,289,203,86,23,10,0,20,12,1,1,1,77
6,10,Minnesota Monarchs,Minnesota,MIN,66,40,21,5,85,0.644,40,293,221,72,25,6,2,15,15,3,0,2,77
7,0,Buffalo Stampede,Buffalo,BUF,66,40,21,5,85,0.644,37,279,226,53,20,11,2,20,10,3,3,1,77
8,14,New Orleans Specters,New Orleans,NOL,66,40,23,3,83,0.629,40,252,204,48,23,8,2,17,15,1,0,0,77
9,5,New England Wolfpack,New England,NEW,66,40,24,2,82,0.621,38,324,238,86,24,8,1,16,16,1,2,1,77
10,6,Tampa Bay Barracuda,Tampa Bay,TBB,66,37,25,4,78,0.591,37,263,207,56,22,10,1,15,15,3,0,3,77
11,7,Baltimore Platoon,Baltimore,BAP,66,37,26,3,77,0.583,35,292,248,44,22,10,1,15,16,2,2,0,77
12,3,Toronto North Stars,Toronto,TOR,66,30,34,2,62,0.470,28,252,273,-21,19,14,0,11,20,2,2,2,77
13,1,Chicago Syndicate,Chicago,CHI,66,30,35,1,61,0.462,29,260,319,-59,17,15,1,13,20,0,1,1,77
14,2,Hamilton Steelhawks,Hamilton,HAM,66,27,37,2,56,0.424,23,230,301,-71,16,16,1,11,21,1,4,0,77
15,11,Winnipeg Aurora,Winnipeg,WPG,66,26,37,3,55,0.417,26,216,268,-52,18,14,1,8,23,2,0,2,77
16,4,Manhattan Rage,Manhattan,MAN,66,22,42,2,46,0.348,22,245,343,-98,14,19,0,8,23,2,0,1,77
17,8,Calgary Dragons,Calgary,CGY,66,20,40,6,46,0.348,19,210,315,-105,11,18,4,9,22,2,1,1,77
18,19,Seattle Argonauts,Seattle,SEA,66,20,45,1,41,0.311,20,222,308,-86,9,23,1,11,22,0,0,1,77
19,9,Edmonton Blizzard,Edmonton,EDM,66,12,52,2,26,0.197,10,196,368,-172,7,24,2,5,28,0,2,1,77
20,20,Montreal Patriotes,Montreal,MTL,66,7,56,3,17,0.129,7,177,389,-212,7,25,1,0,31,2,0,1,77
1,13,Los Angeles Panthers,Los Angeles,LAP,66,49,12,5,103,0.780,49,332,204,128,25,6,2,24,6,3,0,3,78
2,12,San Francisco Pride,San Francisco,SFP,66,48,15,3,99,0.750,46,353,213,140,26,6,1,22,9,2,2,2,78
3,15,Texas Renegades,Texas,TEX,66,48,15,3,99,0.750,41,300,194,106,27,5,1,21,10,2,7,1,78
4,6,Tampa Bay Barracuda,Tampa Bay,TBB,66,45,14,7,97,0.735,42,315,200,115,26,2,5,19,12,2,3,4,78
5,21,Philadelphia Forge,Philadelphia,PHI,66,43,20,3,89,0.674,42,319,233,86,21,9,3,22,11,0,1,3,78
6,18,Atlanta Inferno,Atlanta,ATL,66,38,22,6,82,0.621,36,284,245,39,25,5,3,13,17,3,2,3,78
7,5,New England Wolfpack,New England,NEW,66,39,23,4,82,0.621,35,298,249,49,22,10,1,17,13,3,4,0,78
8,3,Toronto North Stars,Toronto,TOR,66,38,25,3,79,0.598,35,250,251,-1,23,10,0,15,15,3,3,2,78
9,7,Baltimore Platoon,Baltimore,BAP,66,36,24,6,78,0.591,36,275,238,37,23,6,4,13,18,2,0,4,78
10,8,Calgary Dragons,Calgary,CGY,66,36,24,6,78,0.591,35,255,231,24,24,7,2,12,17,4,1,1,78
11,14,New Orleans Specters,New Orleans,NOL,66,35,27,4,74,0.561,32,253,244,9,19,12,2,16,15,2,3,1,78
12,0,Buffalo Stampede,Buffalo,BUF,66,32,28,6,70,0.530,30,293,283,10,19,12,2,13,16,4,2,2,78
13,10,Minnesota Monarchs,Minnesota,MIN,66,27,32,7,61,0.462,27,233,265,-32,17,11,5,10,21,2,0,6,78
14,11,Winnipeg Aurora,Winnipeg,WPG,66,26,35,5,57,0.432,23,227,272,-45,15,16,2,11,19,3,3,1,78
15,2,Hamilton Steelhawks,Hamilton,HAM,66,25,34,7,57,0.432,23,258,301,-43,15,14,4,10,20,3,2,2,78
16,4,Manhattan Rage,Manhattan,MAN,66,26,37,3,55,0.417,23,226,321,-95,14,17,2,12,20,1,3,0,78
17,19,Seattle Argonauts,Seattle,SEA,66,22,38,6,50,0.379,20,198,293,-95,13,20,0,9,18,6,2,1,78
18,1,Chicago Syndicate,Chicago,CHI,66,18,45,3,39,0.295,17,188,322,-134,12,21,0,6,24,3,1,1,78
19,20,Montreal Patriotes,Montreal,MTL,66,17,48,1,35,0.265,17,210,338,-128,10,22,1,7,26,0,0,0,78
20,9,Edmonton Blizzard,Edmonton,EDM,66,12,50,4,28,0.212,12,173,343,-170,6,25,2,6,25,2,0,2,78
1,12,San Francisco Pride,San Francisco,SFP,66,49,15,2,100,0.758,48,346,203,143,28,5,0,21,10,2,1,0,79
2,13,Los Angeles Panthers,Los Angeles,LAP,66,48,17,1,97,0.735,48,309,221,88,28,5,0,20,12,1,0,0,79
3,15,Texas Renegades,Texas,TEX,66,44,21,1,89,0.674,44,295,234,61,26,7,0,18,14,1,0,1,79
4,21,Philadelphia Forge,Philadelphia,PHI,66,42,21,3,87,0.659,41,330,243,87,25,8,0,17,13,3,1,2,79
5,8,Calgary Dragons,Calgary,CGY,66,41,21,4,86,0.652,35,270,244,26,25,6,2,16,15,2,6,2,79
6,5,New England Wolfpack,New England,NEW,66,39,20,7,85,0.644,35,299,259,40,23,8,2,16,12,5,4,4,79
7,3,Toronto North Stars,Toronto,TOR,66,39,23,4,82,0.621,38,264,216,48,23,9,1,16,14,3,1,2,79
8,6,Tampa Bay Barracuda,Tampa Bay,TBB,66,38,23,5,81,0.614,37,278,231,47,23,10,0,15,13,5,1,4,79
9,7,Baltimore Platoon,Baltimore,BAP,66,37,26,3,77,0.583,35,261,228,33,23,9,1,14,17,2,2,2,79
10,18,Atlanta Inferno,Atlanta,ATL,66,34,26,6,74,0.561,33,287,248,39,19,10,4,15,16,2,1,3,79
11,0,Buffalo Stampede,Buffalo,BUF,66,33,26,7,73,0.553,29,242,239,3,18,12,3,15,14,4,4,1,79
12,14,New Orleans Specters,New Orleans,NOL,66,32,30,4,68,0.515,29,235,233,2,18,14,1,14,16,3,3,2,79
13,19,Seattle Argonauts,Seattle,SEA,66,28,35,3,59,0.447,25,224,290,-66,18,14,1,10,21,2,3,0,79
14,10,Minnesota Monarchs,Minnesota,MIN,66,26,36,4,56,0.424,25,227,264,-37,16,14,3,10,22,1,1,2,79
15,11,Winnipeg Aurora,Winnipeg,WPG,66,25,36,5,55,0.417,22,223,284,-61,15,13,5,10,23,0,3,4,79
16,4,Manhattan Rage,Manhattan,MAN,66,22,35,9,53,0.402,21,238,302,-64,12,16,5,10,19,4,1,6,79
17,20,Montreal Patriotes,Montreal,MTL,66,24,38,4,52,0.394,23,222,284,-62,13,18,2,11,20,2,1,0,79
18,2,Hamilton Steelhawks,Hamilton,HAM,66,21,42,3,45,0.341,17,231,340,-109,11,20,2,10,22,1,4,2,79
19,1,Chicago Syndicate,Chicago,CHI,66,21,43,2,44,0.333,19,224,320,-96,14,18,1,7,25,1,2,2,79
20,9,Edmonton Blizzard,Edmonton,EDM,66,17,45,4,38,0.288,16,239,361,-122,10,21,2,7,24,2,1,1,79
1,18,Atlanta Inferno,Atlanta,ATL,66,54,10,2,110,0.833,52,355,200,155,30,3,0,24,7,2,2,0,80
2,12,San Francisco Pride,San Francisco,SFP,66,46,14,6,98,0.742,45,329,191,138,27,4,2,19,10,4,1,4,80
3,6,Tampa Bay Barracuda,Tampa Bay,TBB,66,43,19,4,90,0.682,43,318,229,89,23,8,2,20,11,2,0,2,80
4,0,Buffalo Stampede,Buffalo,BUF,66,40,21,5,85,0.644,38,276,238,38,23,7,3,17,14,2,2,3,80
5,19,Seattle Argonauts,Seattle,SEA,66,39,20,7,85,0.644,36,284,253,31,24,8,1,15,12,6,3,3,80
6,14,New Orleans Specters,New Orleans,NOL,66,39,23,4,82,0.621,37,265,212,53,20,10,3,19,13,1,2,0,80
7,15,Texas Renegades,Texas,TEX,66,38,24,4,80,0.606,37,277,239,38,21,9,3,17,15,1,1,3,80
8,4,Manhattan Rage,Manhattan,MAN,66,38,24,4,80,0.606,35,265,245,20,20,10,3,18,14,1,3,0,80
9,21,Philadelphia Forge,Philadelphia,PHI,66,38,25,3,79,0.598,38,315,246,69,24,8,1,14,17,2,0,2,80
10,8,Calgary Dragons,Calgary,CGY,66,36,25,5,77,0.583,34,261,243,18,22,9,2,14,16,3,2,3,80
11,13,Los Angeles Panthers,Los Angeles,LAP,66,35,27,4,74,0.561,33,275,243,32,21,10,2,14,17,2,2,1,80
12,7,Baltimore Platoon,Baltimore,BAP,66,32,30,4,68,0.515,31,253,265,-12,23,9,1,9,21,3,1,2,80
13,5,New England Wolfpack,New England,NEW,66,28,34,4,60,0.455,28,258,302,-44,18,13,2,10,21,2,0,2,80
14,3,Toronto North Stars,Toronto,TOR,66,23,35,8,54,0.409,21,220,287,-67,17,15,1,6,20,7,2,2,80
15,2,Hamilton Steelhawks,Hamilton,HAM,66,25,38,3,53,0.402,24,258,311,-53,15,16,2,10,22,1,1,1,80
16,1,Chicago Syndicate,Chicago,CHI,66,23,36,7,53,0.402,19,203,279,-76,13,19,1,10,17,6,4,2,80
17,11,Winnipeg Aurora,Winnipeg,WPG,66,23,39,4,50,0.379,21,225,305,-80,17,14,2,6,25,2,2,0,80
18,20,Montreal Patriotes,Montreal,MTL,66,23,40,3,49,0.371,21,226,287,-61,16,17,0,7,23,3,2,1,80
19,10,Minnesota Monarchs,Minnesota,MIN,66,19,46,1,39,0.295,17,180,326,-146,12,21,0,7,25,1,2,0,80
20,9,Edmonton Blizzard,Edmonton,EDM,66,18,46,2,38,0.288,18,187,329,-142,14,18,1,4,28,1,0,1,80
1,12,San Francisco Pride,San Francisco,SFP,66,47,16,3,97,0.735,46,331,185,146,28,4,1,19,12,2,1,1,81
2,18,Atlanta Inferno,Atlanta,ATL,66,45,16,5,95,0.720,44,293,190,103,26,4,3,19,12,2,1,3,81
3,21,Philadelphia Forge,Philadelphia,PHI,66,41,20,5,87,0.659,40,300,254,46,24,6,3,17,14,2,1,3,81
4,15,Texas Renegades,Texas,TEX,66,42,21,3,87,0.659,39,299,241,58,25,6,2,17,15,1,3,0,81
5,19,Seattle Argonauts,Seattle,SEA,66,40,25,1,81,0.614,39,277,239,38,27,5,1,13,20,0,1,0,81
6,14,New Orleans Specters,New Orleans,NOL,66,38,24,4,80,0.606,36,258,222,36,25,8,0,13,16,4,2,3,81
7,20,Montreal Patriotes,Montreal,MTL,66,38,26,2,78,0.591,37,280,223,57,25,6,2,13,20,0,1,1,81
8,5,New England Wolfpack,New England,NEW,66,36,25,5,77,0.583,34,270,247,23,23,7,3,13,18,2,2,1,81
9,1,Chicago Syndicate,Chicago,CHI,66,36,26,4,76,0.576,35,278,254,24,25,8,0,11,18,4,1,1,81
10,8,Calgary Dragons,Calgary,CGY,66,35,27,4,74,0.561,35,275,259,16,23,10,0,12,17,4,0,1,81
11,6,Tampa Bay Barracuda,Tampa Bay,TBB,66,36,29,1,73,0.553,35,270,247,23,23,9,1,13,20,0,1,0,81
12,13,Los Angeles Panthers,Los Angeles,LAP,66,33,26,7,73,0.553,32,278,244,34,19,9,5,14,17,2,1,2,81
13,7,Baltimore Platoon,Baltimore,BAP,66,32,30,4,68,0.515,30,246,259,-13,19,12,2,13,18,2,2,2,81
14,0,Buffalo Stampede,Buffalo,BUF,66,31,30,5,67,0.508,30,264,247,17,17,14,2,14,16,3,1,2,81
15,11,Winnipeg Aurora,Winnipeg,WPG,66,27,32,7,61,0.462,25,219,251,-32,19,10,4,8,22,3,2,3,81
16,3,Toronto North Stars,Toronto,TOR,66,27,35,4,58,0.439,25,237,275,-38,18,15,0,9,20,4,2,3,81
17,4,Manhattan Rage,Manhattan,MAN,66,26,36,4,56,0.424,23,225,281,-56,15,15,3,11,21,1,3,3,81
18,9,Edmonton Blizzard,Edmonton,EDM,66,24,36,6,54,0.409,22,214,303,-89,15,15,3,9,21,3,2,0,81
19,2,Hamilton Steelhawks,Hamilton,HAM,66,17,46,3,37,0.280,14,240,372,-132,11,21,1,6,25,2,3,1,81
20,10,Minnesota Monarchs,Minnesota,MIN,66,9,54,3,21,0.159,7,155,416,-261,6,26,1,3,28,2,2,2,81
1,8,Calgary Dragons,Calgary,CGY,66,48,15,3,99,0.750,44,296,186,110,29,3,1,19,12,2,4,1,82
2,18,Atlanta Inferno,Atlanta,ATL,66,47,15,4,98,0.742,41,292,198,94,29,3,1,18,12,3,6,1,82
3,6,Tampa Bay Barracuda,Tampa Bay,TBB,66,46,15,5,97,0.735,45,311,193,118,28,5,0,18,10,5,1,3,82
4,19,Seattle Argonauts,Seattle,SEA,66,41,21,4,86,0.652,41,293,227,66,20,11,2,21,10,2,0,2,82
5,9,Edmonton Blizzard,Edmonton,EDM,66,39,22,5,83,0.629,39,304,232,72,24,6,3,15,16,2,0,2,82
6,5,New England Wolfpack,New England,NEW,66,39,24,3,81,0.614,37,297,245,52,20,10,3,19,14,0,2,1,82
7,20,Montreal Patriotes,Montreal,MTL,66,38,26,2,78,0.591,36,236,218,18,26,6,1,12,20,1,2,0,82
8,13,Los Angeles Panthers,Los Angeles,LAP,66,35,23,8,78,0.591,31,290,250,40,20,11,2,15,12,6,4,4,82
9,21,Philadelphia Forge,Philadelphia,PHI,66,34,29,3,71,0.538,31,263,261,2,19,13,1,15,16,2,3,1,82
10,14,New Orleans Specters,New Orleans,NOL,66,33,28,5,71,0.538,31,267,270,-3,21,11,1,12,17,4,2,3,82
11,1,Chicago Syndicate,Chicago,CHI,66,31,29,6,68,0.515,31,274,256,18,16,15,2,15,14,4,0,2,82
12,15,Texas Renegades,Texas,TEX,66,32,30,4,68,0.515,30,227,261,-34,18,15,0,14,15,4,2,2,82
13,11,Winnipeg Aurora,Winnipeg,WPG,66,31,30,5,67,0.508,31,257,274,-17,17,14,2,14,16,3,0,1,82
14,4,Manhattan Rage,Manhattan,MAN,66,30,33,3,63,0.477,29,254,272,-18,18,13,2,12,20,1,1,2,82
15,2,Hamilton Steelhawks,Hamilton,HAM,66,29,33,4,62,0.470,28,239,287,-48,16,15,2,13,18,2,1,3,82
16,0,Buffalo Stampede,Buffalo,BUF,66,24,34,8,56,0.424,24,197,249,-52,14,14,5,10,20,3,0,3,82
17,7,Baltimore Platoon,Baltimore,BAP,66,25,36,5,55,0.417,23,219,271,-52,18,12,3,7,24,2,2,2,82
18,12,San Francisco Pride,San Francisco,SFP,66,21,42,3,45,0.341,19,195,299,-104,12,18,3,9,24,0,2,1,82
19,3,Toronto North Stars,Toronto,TOR,66,21,42,3,45,0.341,18,223,329,-106,16,17,0,5,25,3,3,2,82
20,10,Minnesota Monarchs,Minnesota,MIN,66,16,46,4,36,0.273,14,220,376,-156,10,21,2,6,25,2,2,1,82
1,9,Edmonton Blizzard,Edmonton,EDM,66,52,14,0,104,0.788,52,412,219,193,28,5,0,24,9,0,0,0,83
2,18,Atlanta Inferno,Atlanta,ATL,66,50,14,2,102,0.773,50,342,195,147,27,4,2,23,10,0,0,1,83
3,1,Chicago Syndicate,Chicago,CHI,66,49,15,2,100,0.758,48,318,212,106,24,7,2,25,8,0,1,0,83
4,19,Seattle Argonauts,Seattle,SEA,66,48,14,4,100,0.758,47,347,202,145,29,2,2,19,12,2,1,2,83
5,5,New England Wolfpack,New England,NEW,66,45,16,5,95,0.720,43,332,199,133,22,10,1,23,6,4,2,2,83
6,21,Philadelphia Forge,Philadelphia,PHI,66,44,16,6,94,0.712,41,279,199,80,25,6,2,19,10,4,3,2,83
7,14,New Orleans Specters,New Orleans,NOL,66,42,21,3,87,0.659,42,305,222,83,24,9,0,18,12,3,0,1,83
8,4,Manhattan Rage,Manhattan,MAN,66,42,22,2,86,0.652,41,296,250,46,23,8,2,19,14,0,1,0,83
9,6,Tampa Bay Barracuda,Tampa Bay,TBB,66,40,23,3,83,0.629,38,329,238,91,22,10,1,18,13,2,2,2,83
10,24,Denver Glacier Guardians,Denver,DEN,66,39,26,1,79,0.598,37,306,285,21,18,15,0,21,11,1,2,0,83
11,11,Winnipeg Aurora,Winnipeg,WPG,66,37,26,3,77,0.583,36,254,238,16,21,12,0,16,14,3,1,1,83
12,20,Montreal Patriotes,Montreal,MTL,66,33,30,3,69,0.523,32,260,249,11,19,11,3,14,19,0,1,1,83
13,2,Hamilton Steelhawks,Hamilton,HAM,66,33,30,3,69,0.523,32,245,243,2,18,13,2,15,17,1,1,1,83
14,22,Cincinnati Six,Cincinnati,CIN,66,33,32,1,67,0.508,30,242,252,-10,17,15,1,16,17,0,3,1,83
15,7,Baltimore Platoon,Baltimore,BAP,66,30,32,4,64,0.485,30,261,272,-11,18,14,1,12,18,3,0,1,83
16,23,Nashville Sound,Nashville,NSH,66,31,33,2,64,0.485,28,253,271,-18,15,16,2,16,17,0,3,1,83
17,0,Buffalo Stampede,Buffalo,BUF,66,28,35,3,59,0.447,26,211,244,-33,17,14,2,11,21,1,2,1,83
18,15,Texas Renegades,Texas,TEX,66,26,37,3,55,0.417,26,211,243,-32,15,18,0,11,19,3,0,3,83
19,3,Toronto North Stars,Toronto,TOR,66,20,43,3,43,0.326,19,209,338,-129,11,20,2,9,23,1,1,1,83
20,25,Madison Valkyries,Madison,MAD,66,20,43,3,43,0.326,18,160,274,-114,12,18,3,8,25,0,2,2,83
21,8,Calgary Dragons,Calgary,CGY,66,18,45,3,39,0.295,16,217,358,-141,12,19,2,6,26,1,2,2,83
22,12,San Francisco Pride,San Francisco,SFP,66,13,48,5,31,0.235,13,198,326,-128,10,19,4,3,29,1,0,3,83
23,13,Los Angeles Panthers,Los Angeles,LAP,66,12,51,3,27,0.205,10,160,399,-239,5,25,3,7,26,0,2,2,83
24,10,Minnesota Monarchs,Minnesota,MIN,66,7,57,2,16,0.121,6,138,357,-219,4,27,2,3,30,0,1,1,83
1,9,Edmonton Blizzard,Edmonton,EDM,66,57,8,1,115,0.871,57,464,210,254,28,4,1,29,4,0,0,0,84
2,1,Chicago Syndicate,Chicago,CHI,66,54,10,2,110,0.833,53,342,169,173,30,3,0,24,7,2,1,1,84
3,19,Seattle Argonauts,Seattle,SEA,66,50,12,4,104,0.788,47,360,187,173,25,6,2,25,6,2,3,0,84
4,18,Atlanta Inferno,Atlanta,ATL,66,50,12,4,104,0.788,47,342,238,104,28,5,0,22,7,4,3,2,84
5,4,Manhattan Rage,Manhattan,MAN,66,45,16,5,95,0.720,45,357,225,132,26,6,1,19,10,4,0,1,84
6,5,New England Wolfpack,New England,NEW,66,42,19,5,89,0.674,40,328,227,101,25,7,1,17,12,4,2,3,84
7,21,Philadelphia Forge,Philadelphia,PHI,66,35,22,9,79,0.598,34,272,232,40,20,8,5,15,14,4,1,4,84
8,7,Baltimore Platoon,Baltimore,BAP,66,37,25,4,78,0.591,34,278,260,18,25,7,1,12,18,3,3,2,84
9,6,Tampa Bay Barracuda,Tampa Bay,TBB,66,36,25,5,77,0.583,33,300,254,46,22,8,3,14,17,2,3,3,84
10,14,New Orleans Specters,New Orleans,NOL,66,36,28,2,74,0.561,33,261,264,-3,22,11,0,14,17,2,3,1,84
11,2,Hamilton Steelhawks,Hamilton,HAM,66,35,27,4,74,0.561,32,272,259,13,21,11,1,14,16,3,3,3,84
12,20,Montreal Patriotes,Montreal,MTL,66,35,28,3,73,0.553,34,268,254,14,20,11,2,15,17,1,1,1,84
13,24,Denver Glacier Guardians,Denver,DEN,66,34,28,4,72,0.545,34,264,274,-10,22,10,1,12,18,3,0,3,84
14,0,Buffalo Stampede,Buffalo,BUF,66,30,32,4,64,0.485,27,223,281,-58,17,13,3,13,19,1,3,3,84
15,25,Madison Valkyries,Madison,MAD,66,27,33,6,60,0.455,26,229,300,-71,15,15,3,12,18,3,1,1,84
16,11,Winnipeg Aurora,Winnipeg,WPG,66,27,35,4,58,0.439,26,235,272,-37,19,13,1,8,22,3,1,3,84
17,22,Cincinnati Six,Cincinnati,CIN,66,26,34,6,58,0.439,23,274,324,-50,13,18,2,13,16,4,3,3,84
18,23,Nashville Sound,Nashville,NSH,66,26,36,4,56,0.424,25,264,317,-53,14,17,2,12,19,2,1,0,84
19,13,Los Angeles Panthers,Los Angeles,LAP,66,25,37,4,54,0.409,23,283,351,-68,13,19,1,12,18,3,2,1,84
20,8,Calgary Dragons,Calgary,CGY,66,24,37,5,53,0.402,21,243,358,-115,16,16,1,8,21,4,3,2,84
21,10,Minnesota Monarchs,Minnesota,MIN,66,17,46,3,37,0.280,17,205,327,-122,9,22,2,8,24,1,0,0,84
22,15,Texas Renegades,Texas,TEX,66,16,46,4,36,0.273,15,201,318,-117,9,23,1,7,23,3,1,1,84
23,3,Toronto North Stars,Toronto,TOR,66,16,48,2,34,0.258,13,195,353,-158,9,22,2,7,26,0,3,0,84
24,12,San Francisco Pride,San Francisco,SFP,66,12,48,6,30,0.227,11,188,394,-206,6,23,4,6,25,2,1,4,84
